PYRAMIDA		PYRAMIDA
EASTER			EASTER
STONEHOOD		STONEHOOD
ELDRUID			ELDRUID
CROMANYON		CROMANYON
XMARS                   XMARS
HISTERRA                HISTERRA
ALIENTRANCE		ALIENTRANCE
BIODAMAGE		BIODAMAGE
SPINE			SPINE
MOUNTIME		MOUNTIME
CLOX			CLOX
ISOLAND			ISOLAND
ZEROS			ZEROS
RELIC			RELIC
ABDULA			ABDULA
VULCAN			VULCAN
ZABRICK			ZABRICK
ROOT			ROOT
PILLOID			PILLOID
SOTA			SOTA
RAGAR			RAGAR
PIZZA			PIZZA
MOULD			MOULD
NORD			NORD
GOT			GOT
QUATREFOIL		QUATREFOIL
FISH			FISH
JUNCTION		JUNCTION
OSSA			OSSA
ASH			ASH
BONEYARD		BONEYARD
KRUGH			KRUGH
TINI			TINI
FLAT			FLAT
SPUNGE			SPUNGE
GLETSCHER		GLETSCHER
UNREGISTERED            UNREGISTERED
